sex,sat_v,sat_m,sat_sum,hs_gpa,fy_gpa
1,65,62,127,3.4,1
2,58,64,122,4,1
2,56,60,116,3.75,1
1,42,53,95,3.75,0
1,55,52,107,4,0
2,55,56,111,4,0
1,57,65,122,2.8,0
1,53,62,115,3.8,0
2,67,77,144,4,1
1,41,44,85,2.6,0
1,58,70,128,3.75,1
2,45,57,102,3.75,1
2,43,45,88,2.8,0
2,50,58,108,3.75,1
1,54,66,120,3.5,1
2,55,57,112,3.75,1
2,44,53,97,3.2,0
1,53,68,121,4,1
2,54,49,103,3.75,1
2,47,55,102,4,1
1,64,76,140,4,1
2,39,33,72,3.25,0
1,52,65,117,3.9,1
1,49,58,107,3.5,0
1,46,40,86,3.5,0
2,43,49,92,2,0
1,63,72,135,4,1
2,46,45,91,2.3,0
1,45,53,98,3.5,0
1,35,45,80,3.5,0
2,54,53,107,4,1
2,66,66,132,3.75,1
1,40,50,90,3,0
2,53,67,120,4,1
1,64,62,126,2.8,1
1,44,39,83,2.75,0
1,69,64,133,3.5,0
2,47,60,107,3.75,0
1,33,48,81,2,0
1,61,63,124,3.75,0
2,40,42,82,2.75,0
1,52,62,114,3,0
1,56,61,117,2.25,0
1,38,49,87,3.5,0
1,54,47,101,3,0
1,33,43,76,3,0
2,36,45,81,2.67,0
2,36,47,83,3,0
2,64,60,124,3.8,1
1,49,42,91,3.1,0
1,57,66,123,3,0
1,50,60,110,3,0
2,48,49,97,3,1
2,54,55,109,3.25,0
1,64,66,130,3.2,0
2,57,50,107,3.8,1
2,49,55,104,2.5,0
2,64,68,132,4,1
1,66,57,123,3.75,0
2,43,46,89,3.5,0
1,46,50,96,2.9,0
1,41,51,92,2.9,1
1,62,64,126,2.3,0
1,43,63,106,2.8,0
2,52,52,104,4,1
2,45,54,99,4,1
2,45,59,104,3.8,0
2,71,59,130,4,0
2,43,52,95,3.25,0
1,55,54,109,2.7,0
1,40,62,102,3.5,0
2,66,61,127,3,0
1,54,62,116,3.25,0
1,45,60,105,2.75,0
1,57,56,113,3,0
2,37,51,88,2.5,0
2,35,40,75,2.8,0
1,61,59,120,3.5,0
2,50,51,101,3.25,0
1,50,56,106,4,0
1,44,57,101,3.5,0
1,58,50,108,3,0
2,53,56,109,3.5,0
1,42,52,94,3.75,0
1,60,57,117,4,0
1,39,53,92,3,0
1,49,50,99,3.5,0
1,45,65,110,4,1
1,60,67,127,4,0
2,50,43,93,3.75,1
1,29,50,79,3.25,0
1,48,60,108,3.75,0
2,34,40,74,3,0
1,49,47,96,2.5,0
2,50,67,117,4,0
2,53,52,105,3.75,0
1,62,63,125,4,0
2,53,56,109,2.7,0
1,46,55,101,3.5,0
2,63,57,120,3.2,0
2,44,64,108,3.5,0
2,63,57,120,2.75,0
2,49,58,107,3.4,0
1,42,55,97,2.8,0
1,58,56,114,2,0
1,63,73,136,4,0
2,62,64,126,4,1
2,57,60,117,3.9,1
1,45,71,116,3,0
1,59,72,131,3,0
2,45,64,109,4,0
2,52,52,104,2,1
1,43,64,107,3,0
2,43,46,89,3.7,0
1,60,68,128,4,1
1,50,77,127,3.75,1
1,61,58,119,2.5,0
1,48,59,107,3,1
1,71,70,141,3.5,0
1,54,71,125,4,1
2,53,54,107,4,1
2,45,46,91,3.75,0
1,55,68,123,3.5,1
1,63,66,129,3.8,1
1,51,59,110,3,0
1,43,39,82,2.3,0
2,50,49,99,3.75,0
2,51,50,101,4,1
1,57,64,121,3.75,1
2,42,44,86,3,0
1,57,64,121,4,0
1,58,66,124,4,1
1,40,57,97,2.6,0
2,49,44,93,2.75,0
1,52,73,125,2.5,0
1,62,58,120,2.5,0
2,52,59,111,3.75,1
2,35,50,85,3.5,1
2,54,59,113,4,0
2,67,70,137,4,1
2,52,45,97,3.25,1
2,45,53,98,3.2,0
1,51,73,124,3.75,1
2,53,51,104,2.75,1
1,67,66,133,3.75,1
2,59,63,122,4,1
1,64,70,134,3.75,1
2,58,58,116,3.75,1
2,46,57,103,3.25,0
1,39,56,95,3,0
2,45,55,100,3.5,1
1,48,54,102,3,0
2,41,58,99,3,0
2,54,60,114,3.5,0
1,54,55,109,3.67,0
2,38,32,70,2.4,0
2,57,66,123,3.5,1
2,44,59,103,2,0
2,35,52,87,3,0
1,60,53,113,3.5,0
1,53,62,115,4,1
2,41,52,93,4,1
1,44,44,88,3,0
2,51,54,105,4,1
2,54,69,123,4,1
1,68,69,137,3.5,0
1,56,67,123,4,0
1,41,49,90,2,0
1,62,71,133,3.7,1
2,55,57,112,4,1
2,34,37,71,2.8,0
2,49,43,92,3.25,0
2,49,62,111,3.75,1
2,49,61,110,2.75,0
1,42,65,107,2.25,0
1,49,48,97,3,0
2,57,45,102,2.25,0
2,43,47,90,2.5,0
1,40,46,86,2,0
1,49,54,103,3.2,0
1,56,46,102,2.5,0
1,38,50,88,2.5,0
1,58,64,122,3,1
2,41,47,88,4,0
2,42,51,93,2.5,0
1,53,51,104,2.3,0
2,53,41,94,2.9,0
2,53,59,112,2.75,1
1,62,69,131,3,1
2,59,69,128,3.2,0
2,45,45,90,3,0
1,58,57,115,3.4,0
2,62,57,119,4,1
2,37,55,92,3.5,0
2,53,56,109,3.25,0
1,50,63,113,3.4,0
2,45,63,108,2.75,0
2,35,41,76,2,0
2,35,32,67,2.25,0
2,44,41,85,2.5,0
2,52,53,105,3.5,1
1,41,43,84,2.25,0
2,32,38,70,2.2,0
1,65,64,129,2.5,0
1,50,48,98,2,0
1,58,57,115,2.5,1
1,42,50,92,2.7,0
1,39,43,82,2.25,0
1,53,70,123,4,1
1,49,54,103,3,0
1,52,66,118,3.75,1
1,51,56,107,2.75,1
1,58,57,115,3,1
1,56,64,120,4,1
1,40,58,98,2.75,0
2,63,56,119,4,0
1,48,53,101,2.67,0
2,53,62,115,4,1
2,73,60,133,4,1
1,47,41,88,3,0
1,57,49,106,3,0
2,44,56,100,2.6,0
2,49,54,103,3.33,0
2,62,57,119,4,1
1,50,68,118,3,0
2,61,49,110,4,0
2,64,59,123,4,1
1,48,64,112,3.8,1
1,36,53,89,2.75,0
2,42,60,102,3.8,0
1,54,61,115,3.25,0
2,49,51,100,3.75,0
1,54,51,105,3.5,0
1,43,49,92,2.25,0
1,31,46,77,2,0
2,39,33,72,3.5,0
2,55,59,114,3.25,0
2,53,57,110,3.75,1
1,47,45,92,3.75,0
1,69,61,130,4,1
2,55,38,93,2.75,0
1,44,55,99,3.75,0
2,53,50,103,3.25,0
2,68,62,130,3.7,0
2,39,35,74,3.1,0
1,40,45,85,3,0
1,44,54,98,3.75,1
2,52,52,104,3,0
2,59,49,108,3,0
2,63,54,117,3.75,1
1,62,71,133,4,1
1,48,41,89,2.3,0
1,52,52,104,3.75,1
1,43,50,93,2.5,0
1,47,64,111,4,1
2,33,32,65,3,0
2,67,54,121,3.25,0
2,51,41,92,3.5,0
2,43,52,95,4,1
2,40,42,82,3.5,0
1,50,58,108,4,1
2,76,57,133,4,1
2,47,50,97,3.5,0
2,45,49,94,3.4,0
2,41,38,79,3.6,0
1,56,54,110,4,0
1,57,58,115,3,0
1,36,52,88,3.4,0
1,38,50,88,3.75,0
1,59,66,125,4,1
2,40,51,91,3.8,0
1,58,62,120,4,1
2,52,52,104,3.75,0
2,64,53,117,3,0
2,42,47,89,3,0
1,41,52,93,2.2,0
2,38,49,87,3.25,0
2,50,55,105,3.25,0
2,66,52,118,2.8,1
2,41,59,100,3.3,0
1,46,62,108,2.1,0
2,59,51,110,3.4,0
1,45,49,94,2.4,0
1,46,58,104,3.7,1
2,50,58,108,2.7,0
1,50,60,110,3.5,0
2,58,57,115,3.6,1
1,56,50,106,2.5,0
1,46,57,103,4,1
2,47,48,95,3.25,1
2,45,51,96,3.1,0
1,55,65,120,2.1,0
2,53,56,109,2.8,0
2,51,55,106,3.5,0
2,42,39,81,3.1,0
1,50,65,115,2.9,1
1,46,57,103,2.8,0
2,69,55,124,4,1
2,55,53,108,2.8,0
2,48,53,101,3.3,0
1,52,46,98,2.5,0
1,53,52,105,2.7,0
1,58,60,118,2.3,0
2,50,48,98,2.6,0
2,44,50,94,2.75,0
2,39,51,90,2.75,0
2,45,53,98,2.5,0
2,63,64,127,3.8,1
2,47,47,94,2.7,0
2,62,56,118,3.25,1
2,44,57,101,2.3,0
1,39,38,77,3.2,0
2,42,42,84,2.9,1
2,48,43,91,2.8,1
1,41,45,86,3.4,1
1,50,59,109,2.5,0
1,48,63,111,3.8,0
2,50,62,112,3.3,1
1,57,62,119,3.2,0
2,47,55,102,3.3,1
1,57,66,123,2.6,0
1,36,56,92,3.1,0
1,42,51,93,3.1,0
2,49,38,87,3.2,0
1,62,75,137,3.8,1
1,42,66,108,3.3,0
1,47,53,100,2.8,0
2,49,58,107,3.5,0
1,45,53,98,2.2,0
2,39,42,81,2.75,0
1,43,50,93,3.25,0
1,39,50,89,3,0
2,54,56,110,3.7,1
2,47,46,93,2.9,0
2,38,43,81,2.7,0
2,39,63,102,2.8,0
1,55,70,125,3.7,0
2,54,61,115,3,0
1,65,60,125,3.5,0
2,44,43,87,4,0
1,56,59,115,3.75,0
2,51,61,112,3.5,0
1,40,58,98,2.9,0
2,47,50,97,3.5,0
2,52,51,103,2.8,0
1,48,54,102,2.8,0
1,50,58,108,3.2,1
1,53,59,112,3.2,0
1,54,44,98,2.7,0
1,51,42,93,3,0
1,53,59,112,2.4,0
2,58,66,124,4,1
2,48,60,108,3,0
1,57,60,117,2.1,0
2,40,34,74,2.75,0
1,41,40,81,2,0
1,49,57,106,2.8,0
2,49,50,99,2.9,0
1,55,57,112,2.5,0
1,37,40,77,3.1,0
1,43,46,89,2.8,0
1,47,59,106,3.1,0
1,53,57,110,3,0
2,40,50,90,3.1,0
2,45,48,93,3.7,0
2,46,47,93,2.9,0
1,54,54,108,2.5,0
1,41,60,101,3.4,0
1,64,64,128,4,1
2,62,61,123,3.75,0
1,48,56,104,3.8,0
2,46,49,95,3.4,0
1,36,64,100,3.5,0
2,40,48,88,3.5,1
2,46,60,106,3.5,1
1,55,60,115,2.7,0
1,51,36,87,2.9,1
2,42,35,77,2.5,0
2,50,53,103,2.8,0
2,50,52,102,4,1
1,41,50,91,2.7,0
1,50,53,103,3.5,0
2,50,53,103,4,1
1,46,54,100,2.9,0
2,60,62,122,3.2,0
1,49,65,114,3.7,1
1,43,59,102,2.7,0
2,50,47,97,2.7,0
2,49,60,109,3,0
1,52,50,102,3.5,0
2,62,52,114,3.2,1
2,47,56,103,2.8,0
2,41,57,98,2.5,0
1,43,64,107,2.5,1
2,46,48,94,3.3,0
1,52,67,119,3.3,1
1,47,71,118,2.4,0
1,47,61,108,3.2,0
2,32,54,86,3,0
2,45,45,90,2.6,0
1,59,59,118,2.4,0
2,52,40,92,3.5,0
2,46,56,102,3.7,0
1,31,51,82,2.7,0
2,35,48,83,3,0
1,45,57,102,3.1,0
1,54,53,107,3.2,0
2,43,47,90,3.7,0
2,52,50,102,3.9,1
1,49,58,107,3.8,0
2,45,49,94,3.1,0
2,62,51,113,2.9,0
1,61,64,125,4,1
1,50,59,109,4,1
1,46,53,99,2.6,0
2,39,64,103,2.9,0
1,42,46,88,2.75,0
2,46,57,103,3.3,0
1,40,62,102,2.7,0
1,45,35,80,2.4,0
1,53,56,109,2.5,0
2,67,59,126,3.4,0
2,59,58,117,3.9,0
2,47,58,105,3.4,0
2,39,45,84,2.5,0
2,39,53,92,2.9,0
1,54,58,112,3,0
1,46,52,98,2.5,0
2,59,56,115,3.8,1
1,48,60,108,3.6,0
1,43,51,94,2.3,0
1,48,62,110,3.4,0
2,34,53,87,3.5,0
2,54,61,115,4,1
1,46,57,103,2.8,1
2,36,43,79,2.9,0
1,53,59,112,4,1
2,64,66,130,3.7,0
1,54,58,112,2.8,0
1,57,55,112,2.7,0
2,51,33,84,2.5,1
2,46,53,99,3.4,0
2,45,43,88,3,0
2,55,58,113,3.8,0
2,49,55,104,3.7,1
2,46,50,96,3.7,1
2,49,62,111,3.6,0
2,50,52,102,3.4,0
1,57,58,115,4,0
2,42,40,82,3.2,0
1,55,48,103,3.2,0
2,54,40,94,2.6,0
2,50,62,112,3.9,0
1,29,58,87,2.7,0
1,39,58,97,2.5,0
2,39,38,77,2.6,0
1,43,43,86,2.9,0
2,34,40,74,2.8,0
2,49,57,106,3.7,0
1,38,60,98,2.9,0
2,54,53,107,3.3,0
1,43,68,111,3.8,0
1,49,55,104,2.2,0
1,44,57,101,3.3,0
1,46,44,90,2.7,0
2,47,57,104,2.9,0
1,56,53,109,2.8,0
2,43,51,94,3.8,0
1,57,57,114,3.3,1
2,39,49,88,3.1,0
2,41,52,93,2.9,0
1,33,57,90,2.8,0
2,39,49,88,2.6,0
1,36,59,95,2.9,0
2,42,59,101,3.5,0
2,58,51,109,3.8,1
1,41,57,98,2.9,0
1,41,59,100,3.3,0
2,46,55,101,3.3,0
2,50,57,107,3.2,0
1,39,49,88,2.9,0
2,44,33,77,3.5,0
2,57,59,116,3.3,0
1,55,57,112,3.4,0
2,44,58,102,3.7,1
2,37,38,75,2.9,0
2,47,48,95,2.7,0
1,53,60,113,3.8,0
2,43,58,101,3.8,1
1,45,47,92,3.7,0
2,48,49,97,3.75,1
1,49,54,103,2.8,0
1,49,55,104,4,1
2,47,54,101,4,0
2,32,57,89,2.7,0
1,37,50,87,2.2,0
1,40,57,97,3.7,0
1,55,55,110,2.9,0
1,53,57,110,3.4,0
2,47,47,94,2.6,0
2,58,71,129,4,1
1,35,53,88,3.9,0
2,47,46,93,3.7,0
1,52,64,116,3.9,1
1,36,48,84,2.8,0
2,38,47,85,2.5,0
1,54,57,111,3.4,0
2,41,44,85,3.7,0
1,45,58,103,3.9,0
1,24,29,53,2.47,0
2,59,62,121,3.5,1
1,45,55,100,2.8,0
2,59,62,121,4,1
1,37,58,95,2.4,0
1,44,59,103,3.5,1
1,54,64,118,3.8,0
2,59,62,121,3.8,1
1,48,55,103,3.2,0
2,44,59,103,3.2,1
2,61,56,117,3.5,0
1,49,55,104,2.3,0
1,53,52,105,3,0
2,55,49,104,2.3,0
2,46,45,91,2.3,0
1,49,57,106,2.1,0
1,53,62,115,3.7,0
1,70,74,144,4,1
2,48,52,100,3.9,1
2,36,41,77,3,0
2,49,57,106,3.8,1
2,48,56,104,3.7,0
1,53,62,115,3.8,1
1,66,67,133,3.2,1
2,41,57,98,3.4,0
1,42,62,104,3.2,0
2,38,45,83,3.4,1
1,43,57,100,3.1,0
2,49,54,103,3.7,0
2,53,40,93,3.33,0
1,40,55,95,2.1,0
1,45,56,101,2.5,0
2,53,51,104,2.8,0
1,43,57,100,2.9,0
2,49,52,101,3.1,0
1,41,52,93,2.1,0
2,38,47,85,3.1,0
1,55,56,111,2.8,0
1,41,57,98,3.5,0
2,39,55,94,3.8,0
2,63,49,112,3.4,1
2,43,44,87,2.8,0
1,47,47,94,2.6,0
1,39,57,96,3,1
1,46,51,97,2.6,0
2,45,52,97,3.1,0
2,51,55,106,3.4,0
1,40,44,84,3.1,0
2,42,55,97,3.4,1
1,50,60,110,3.8,0
1,50,58,108,3.7,0
1,56,52,108,3.25,0
1,54,52,106,3.4,1
2,48,36,84,2.7,0
1,53,49,102,3.5,0
1,48,58,106,3.8,1
2,45,58,103,3.2,0
2,50,52,102,3,0
1,52,53,105,3.5,0
2,62,48,110,3.2,0
1,46,48,94,3.2,0
1,42,50,92,3.1,0
2,48,52,100,3.6,1
1,51,59,110,2.5,0
2,50,42,92,3.5,1
2,55,48,103,3.1,1
1,56,63,119,3,0
1,52,60,112,3.2,0
1,51,57,108,2.5,0
2,41,49,90,2.6,1
1,33,38,71,3.5,0
2,47,43,90,2.6,0
2,54,49,103,3.5,1
1,55,56,111,3.7,0
2,49,57,106,3.7,1
1,45,57,102,2.7,0
1,57,59,116,3.3,0
1,45,54,99,3.5,0
1,60,60,120,3.7,0
1,41,52,93,2.7,0
2,47,51,98,2.56,0
1,44,43,87,1.8,0
2,49,55,104,3.5,0
2,68,51,119,3.1,0
2,39,41,80,2.7,0
2,33,37,70,2.8,0
2,50,54,104,3.6,1
2,46,58,104,3.5,0
2,35,40,75,3.25,0
1,26,50,76,3.2,0
2,36,55,91,2.8,0
2,51,54,105,3.7,0
2,47,51,98,3.9,1
1,47,50,97,3.1,0
1,44,62,106,3.7,1
1,50,50,100,3.1,1
1,34,52,86,3.3,0
2,33,46,79,2.6,0
2,38,34,72,2.8,0
2,46,59,105,3.6,0
1,42,56,98,3.8,1
1,59,55,114,3.5,1
1,42,37,79,4.5,0
2,50,53,103,3.9,1
2,41,55,96,3.4,0
2,42,53,95,3,0
1,41,65,106,2.5,0
2,52,62,114,3.5,0
1,62,67,129,4,1
2,36,38,74,3.5,0
2,47,56,103,4,1
1,38,58,96,2.7,0
1,45,63,108,3.3,0
2,63,63,126,3.8,1
1,44,50,94,3.8,1
1,42,61,103,2.5,0
1,51,63,114,2.5,1
1,57,59,116,3.3,0
1,49,61,110,3.5,1
1,37,64,101,4,0
1,62,71,133,4,1
1,47,59,106,2.5,0
1,55,65,120,3,0
2,43,42,85,2.8,0
1,56,74,130,4,1
2,52,48,100,2.74,0
1,47,60,107,3.5,0
2,51,50,101,3.3,1
1,41,66,107,2.7,0
2,43,42,85,3,0
1,58,51,109,3,1
1,47,37,84,2.6,0
1,41,57,98,3.5,0
1,42,50,92,2.3,0
2,50,43,93,2.3,0
1,55,55,110,4,0
1,45,59,104,3.5,0
2,35,42,77,2.8,0
1,43,50,93,3.4,0
1,48,44,92,3,0
2,40,57,97,3,0
1,44,58,102,3.25,0
1,47,61,108,3.3,0
2,43,47,90,3.5,0
2,39,53,92,2.7,0
1,47,57,104,2.8,0
2,34,69,103,2.1,0
2,49,48,97,3.3,1
2,47,45,92,2.4,0
2,43,53,96,2.6,0
1,61,49,110,2.2,0
1,48,55,103,3.8,0
2,37,46,83,3.1,0
2,51,50,101,3.7,0
2,35,60,95,2.75,0
2,47,67,114,3.6,1
1,41,37,78,2,0
2,43,42,85,2.75,0
2,49,48,97,4,0
1,58,77,135,4,1
2,47,45,92,3.7,0
1,47,53,100,4,1
1,37,52,89,2.5,0
1,36,36,72,2.3,1
2,56,58,114,3,0
2,47,58,105,3.5,0
1,56,50,106,3.3,0
2,43,54,97,3.2,0
2,45,48,93,3,0
1,55,60,115,3,0
1,55,35,90,2.6,0
2,46,47,93,3.4,0
2,39,51,90,3.6,1
2,50,58,108,3.3,1
2,45,57,102,3.6,1
1,52,66,118,3.8,0
2,47,47,94,2.8,0
1,48,47,95,2.4,0
1,35,53,88,2.7,0
2,46,58,104,2.8,0
2,54,47,101,2.5,0
2,50,50,100,3.2,0
1,58,59,117,4,0
1,49,60,109,4,0
2,43,47,90,2.67,0
1,42,52,94,3,0
1,46,51,97,2.7,0
2,52,55,107,3.5,1
1,45,46,91,2.8,0
1,62,60,122,3.8,0
2,58,62,120,4,1
2,57,55,112,4,0
2,60,59,119,3,0
1,43,51,94,2.5,0
1,51,65,116,3.5,0
1,37,55,92,2.3,0
1,49,48,97,3.1,0
2,44,54,98,2.7,0
2,44,52,96,3.5,0
2,27,38,65,2.5,0
1,48,55,103,3.1,0
1,41,59,100,3.5,0
2,35,58,93,3.1,1
1,46,54,100,2.6,0
1,52,64,116,2.7,0
1,61,60,121,3.5,1
1,48,64,112,3.4,0
2,58,58,116,2.9,0
1,44,40,84,2.6,0
1,49,57,106,3.25,1
1,40,45,85,2.1,0
2,52,60,112,3,0
1,36,50,86,3.5,0
2,57,55,112,4,1
2,48,62,110,4,1
1,39,44,83,3,0
2,54,61,115,4,1
2,57,47,104,2.8,0
1,40,48,88,3.25,0
1,35,40,75,3,0
1,61,65,126,3.8,0
1,50,57,107,3.2,0
2,41,52,93,3,0
1,49,68,117,3,0
1,50,57,107,2.8,0
1,60,64,124,3.25,0
1,54,72,126,3.75,1
1,41,56,97,2.6,0
1,44,41,85,2.8,0
1,44,55,99,2.5,0
2,50,42,92,2.4,0
1,40,52,92,2.5,0
2,55,54,109,3.5,1
2,47,44,91,3.1,0
2,38,57,95,4,1
1,56,47,103,2.7,0
2,49,52,101,4,0
1,58,60,118,3.7,1
1,51,64,115,2.6,0
1,42,53,95,2.5,0
2,52,49,101,3.6,1
2,48,51,99,3.9,0
1,48,62,110,3.4,0
2,53,52,105,3.6,0
2,57,57,114,3.8,0
1,44,57,101,3.2,0
2,29,60,89,2.5,0
1,54,45,99,3.7,0
1,41,63,104,3.25,0
2,42,59,101,3.7,1
2,53,65,118,2.9,0
2,49,38,87,2.8,0
1,48,54,102,4,0
1,60,65,125,2.9,1
1,45,57,102,3.25,0
2,46,44,90,2.75,0
2,31,41,72,2.67,0
1,49,60,109,3,0
1,47,43,90,3,1
1,50,50,100,3,0
2,59,69,128,4,1
1,58,61,119,4,1
2,48,60,108,3.3,0
1,52,57,109,3.5,1
1,47,50,97,2.75,0
2,45,55,100,2.7,0
2,37,59,96,4,0
1,56,65,121,3.1,0
2,52,52,104,2.8,0
2,65,57,122,3.8,1
2,42,49,91,4,1
2,48,51,99,3.3,0
2,45,58,103,4,0
1,52,62,114,2.6,0
1,51,57,108,3.2,0
1,46,65,111,2.5,0
1,50,72,122,3.1,1
1,52,61,113,3.1,0
1,52,68,120,4,1
2,45,50,95,2.8,0
2,54,50,104,3.4,1
2,50,60,110,3.25,0
1,41,63,104,4,0
2,44,54,98,3.3,1
2,45,48,93,2.8,0
2,41,64,105,3.5,0
1,45,43,88,2.9,0
1,45,49,94,3,0
1,56,53,109,3.2,0
2,54,53,107,2.3,0
1,50,67,117,3,0
1,58,63,121,3.5,1
1,51,35,86,2.75,0
2,48,45,93,2.8,0
2,41,50,91,3.8,0
2,51,61,112,3.5,1
2,39,34,73,2.7,0
2,54,53,107,3.5,0
2,44,53,97,2.2,0
2,52,44,96,3,0
2,53,37,90,3.3,0
1,37,67,104,2.9,0
1,35,48,83,2.2,0
1,45,53,98,2.4,0
2,43,47,90,3.1,0
1,49,59,108,3.3,0
2,37,43,80,2.03,0
2,41,43,84,3.3,0
2,40,45,85,3,0
1,48,64,112,3,1
1,44,59,103,3.8,0
1,54,60,114,3.5,0
2,63,42,105,2.1,0
1,47,55,102,2.7,0
2,56,52,108,3.5,1
2,50,50,100,3.75,1
1,64,64,128,4,1
2,42,59,101,3.25,1
1,43,48,91,2.8,0
1,43,49,92,3.2,0
1,52,52,104,4,0
2,34,50,84,2,0
2,44,45,89,3.6,0
2,42,43,85,2.4,0
2,47,48,95,4,1
1,52,52,104,2.75,0
2,49,59,108,3,0
2,38,48,86,2.7,0
2,62,56,118,3.7,0
1,61,45,106,2.6,0
1,44,55,99,3,0
2,55,61,116,3.2,0
1,47,66,113,3.5,0
2,44,44,88,3.1,1
1,41,56,97,2.9,0
2,62,59,121,3.7,0
2,60,68,128,3.7,0
2,44,60,104,3.2,1
2,63,58,121,3.7,1
1,45,58,103,2.4,0
1,43,55,98,2.4,0
1,36,45,81,2.5,0
2,58,53,111,3.3,1
2,62,68,130,4,1
1,41,61,102,4,0
1,58,59,117,3.75,0
2,46,43,89,2.7,0
2,45,61,106,4,1
1,40,41,81,2.3,0
1,63,68,131,4,1
2,53,54,107,3.5,0
2,57,72,129,4,1
1,39,56,95,3.75,1
1,45,66,111,2.7,0
1,52,67,119,3,0
1,55,53,108,3.5,0
1,44,48,92,2.2,0
2,56,45,101,3.8,1
1,64,62,126,4,1
2,46,51,97,3.1,0
1,64,61,125,3.6,1
1,60,66,126,2.7,1
1,52,60,112,3.1,0
2,46,61,107,3.75,0
2,58,58,116,3.5,1
2,34,42,76,3.1,0
2,54,64,118,3.8,1
2,50,33,83,2.75,0
1,59,63,122,3.2,0
2,49,45,94,3.7,0
1,37,42,79,2.2,0
2,55,55,110,3.75,1
1,32,66,98,2.9,0
1,41,68,109,3.3,0
2,47,53,100,2.8,0
2,49,41,90,2.7,0
1,53,68,121,3.2,0
2,55,57,112,2.5,0
1,43,52,95,2.7,0
2,43,56,99,3,0
2,50,53,103,3.5,0
1,44,41,85,2,0
1,64,59,123,2.5,1
2,49,48,97,3.8,1
1,49,55,104,3.2,0
1,43,45,88,2.5,0
1,64,71,135,3.3,0
2,54,57,111,3.33,1
2,40,47,87,3.2,0
2,50,53,103,3.2,0
2,57,64,121,3.75,0
1,49,59,108,3.8,0
1,50,55,105,3.2,0
2,53,62,115,3.3,0
1,54,59,113,3.5,0
1,51,56,107,3,0
2,38,40,78,3.8,0
1,61,65,126,3.7,0
2,44,44,88,2.7,0
1,56,61,117,3.7,0
1,48,63,111,3,0
1,55,67,122,3.3,0
1,61,51,112,2.3,1
1,46,44,90,3.6,0
1,51,66,117,3,0
2,67,70,137,3.8,1
1,49,40,89,2.3,0
1,63,50,113,2.9,0
2,40,50,90,2.5,0
2,53,65,118,3.7,1
2,48,42,90,3.6,1
2,43,43,86,2.5,0
1,46,63,109,2.8,0
1,67,60,127,3.3,0
1,46,60,106,3.5,0
2,58,58,116,4,0
2,43,61,104,2.8,0
1,46,43,89,2.8,0
1,49,49,98,3.25,0
2,59,64,123,2.75,0
1,39,55,94,2.8,1
2,39,52,91,3,0
2,67,52,119,4,0
2,55,54,109,3,0
1,57,61,118,3,0
2,51,52,103,2.5,0
1,52,67,119,3.5,1
1,59,48,107,2.5,1
1,45,64,109,2.9,0
2,48,50,98,2.8,0
1,52,52,104,3.5,0
2,41,56,97,2,0
2,47,48,95,3.5,0
2,52,70,122,4,1
1,49,57,106,3.4,0
1,38,53,91,2.5,0
1,44,50,94,2.5,1
1,56,67,123,3.8,0
1,45,58,103,2.75,0
1,59,67,126,3.5,0
1,53,72,125,3.7,1
2,53,38,91,4,1
2,66,66,132,3.5,1
2,36,35,71,2.3,0
2,57,54,111,3.7,0
2,51,51,102,3.5,0
2,76,68,144,4,1
1,60,66,126,4,1
1,46,52,98,3,0
1,54,50,104,2.7,0
2,55,64,119,3.6,1
1,54,63,117,3.3,0
2,52,43,95,3.4,1
2,51,59,110,3.7,1
1,49,51,100,3,0
2,41,50,91,3,1
2,57,59,116,4,1
1,54,52,106,2.7,0
2,32,38,70,2.2,0
2,68,74,142,4,0
2,49,51,100,3.25,0
2,41,45,86,3.5,0
2,47,48,95,3,0
1,51,54,105,3.25,0
1,57,59,116,3,0
1,36,38,74,2.9,0
1,44,59,103,3.67,0
1,47,55,102,2.5,0
1,47,44,91,3,0
1,44,54,98,3.04,0
1,43,46,89,2.5,0
2,39,31,70,2.3,0
1,49,48,97,2.5,0
1,60,53,113,2.2,0
1,50,60,110,3,0
2,40,48,88,3.1,0
2,60,59,119,3.5,0
1,61,57,118,3.2,0
1,42,57,99,2.8,0
1,46,56,102,3.5,0
2,50,56,106,4,0
2,44,57,101,4,1
1,68,73,141,4,1
2,43,45,88,2.5,0
1,54,60,114,3,0
1,49,55,104,3,0
2,50,50,100,3.7,0
1,54,54,108,3.3,0
1,56,58,114,3.5,1
1,55,65,120,2.3,0
1,49,44,93,2.7,0
